xxxxxxxxxxx
x       xGx
x xxxxx x x
x     x   x
x xxx xxxxx
x x x     x
x x xxxxx x
x   x     x
x xxx xxx x
xS    x   x
xxxxxxxxxxx
