xxxxxxxxxxxx
xSx   x    x
x    xxx x x
x xx x   x x
x      xxx x
x  x xxx   x
x xx x   xGx
x      x xxx
x xx x     x
x x  xx xx x
x     x    x
xxxxxxxxxxxx
